NO tex/blue_wall.png
SO tex/green_wall.png
WE tex/red_wall.png
EA tex/yellow_wall.png

F 84,58,58
C 0,204,204



        1111111111111111111111111
        1000000000110000000000001
        1011000001110000000000001
        1001000000000000000000001
111111111011000001110000000000001
100000000011000001110111111111111
111111111111111111111111111111111
11111111111111111111111111111
11110111111111011100000010001
11110111111111011101010010001                11
11000000110101011100000010001                1N1
10000000000000001100000010001                11
10000000000000001101010011001
1100000111010101111101111000111
11110111 1110101 101111010001
11111111 1111111 11111111111