NO ./path_to_the_north_texture
SO ./path_to_the_south_texture
EA /home/path_to_the_south_texture
WE ./path_to_the_south_texture


C 225,55,0
F 220,109,210



patata

        1111111111111111111111111
        1000000000110000000000001
        101100000111000000N000001    1
        10010000000000000000000001  101
 11111111101100000111000000000001    1
10000000001100000111011111111111
11110111111111011100000010001
11110111111111011101010010001
11000000110101011100000010001
10000000000000001100000010001
10000000000000001101010010001
11000001110101011111011110001111111111111111
11110111 1110101 101111010001
11111111 1111111 11111111111