11111111111111111111
1P1C0010000000011E11
101C1C00100101000C11
1C111111100111111111
100000000000000000C1
11111111100111111111
1C1000111001110000C1
10001000100111C10001
11111101100111110011
1C000000000000000001
11111111111111111111