111111111111111111111111111
111111111111PCE111111111111
111111111111111111111111111